XXXXXXXXXXXXXXXXXXXXX
XP___XW_____X____X__X
X___XXX__X__XXX__X__X
X____WWXXX__X____E__X
XXXX________________X
X___WWXX_X__X__XXXXXX
XXX__X___X_____X_E__X
X____________X______X
X_XWWX______XXXX____X
X__X__XX____X__X_XXXX
X__X___X____X_E_____X
XXXXXXXXXXXXXXXXXXXXX