XXXXXXXXXXXXXXXXXXXXXX
XP___X_E____X____X___X
X___XXX__XWWXXX__X___X
X______XXX__X________X
XXXX________W___E____X
X___WWXX_X__XWWXXXXXWX
XXX__X___X__EWWX_____X
XWW__________X_______X
XWX_WX__WWWWXXXX_____X
X__X__XX____X__X_XXX_X
X__X__EX____X__e_____X
XXXXXXXXXXXXXXXXXXXXXX