XXXXXXXXXXXXXXXXXXXXXX
XP___X_E____X____X___X
X___XXX__XWWXXX__X___X
X______XXX__X____E___X
XXXX________W________X
X___WWXX_X__XWWXXXXXWX
XXX__X___X___WWX_E___X
XWW__________X_______X
XWX_WX__WWWWXXXX_____X
X__X__XX____X__X_XXX_X
XE_X___XE___X_E______X
XXXXXXXXXXXXXXXXXXXXXX