XXXXXXXXXXXXXXXXXXXXXX
XP__EX______X____X___X
X___XXX__XWWXXX__X___X
X______XXX__X________X
XXXX________W________X
X___WWXX_X__XWWXXXXXWX
XXX__X___X___WWX_____X
XWW__________X_______X
XWX_WX__WWWWXXXX_____X
X__X__XX____X__X_XXX_X
X__X___X____X________X
XXXXXXXXXXXXXXXXXXXXXX