XXXXXXXXXXXXXXXXXXXXXX
XP___XE_____X____X___X
X___XXX__XWWXXX__X_E_X
X______XXX__X________X
XXXX________W________X
X___WWXX_X__XWWXXXXXWX
XXX__X___X___WWX_E___X
XWW__________X_______X
XWX_WX__WWWWXXXX_____X
X__X__XX____X__X_XXX_X
XE_XE__XE___X___E____X
XXXXXXXXXXXXXXXXXXXXXX