XXXXXXXXXXXXXXXXXXXXXX
XP___X______X____XS__X
X___XXXWWXWWXXX__X___X
X___WW_XXX__X____W___X
XXXX_____W__W____W___X
X___WWXX_X__XWWXXXXXWX
XXXWWX___X___WWX__W__X
XWW________e_XWW__W__X
XWX_WX__WWWWXXXX_____X
X__X__XX____X__X_XXX_X
XE_X___X__W_X____S___X
XXXXXXXXXXXXXXXXXXXXXX